wwwwwwwwwwwwwwwwwwwwwwww
w...k.......d..........w
w......k.............k.w
w..d.............d.....w
w........k.............w
w....kk........k...d...w
w......................w
w..d......k............w
w..............k.....d.w
w..d...................w
w.......d......k...d...w
w...........e..........w
w...k......d.......k...w
w......d...............w
w.d........k.......k...w
w......................w
w...k...d..........d...w
w......k......d......BAw
wwwwwwwwwwwwwwwwwwwwwwww