wwwwwwwwwwwwwwwwwwwwwwww
wB..k.......d..........w
w......k......k......k.w
w..d.............d.....w
wwwww....k.............w
w....kk.....d..k...d...w
w..........ww..........w
w..d......kww..........w
w..........ww..k.....d.w
w..d.....wwwwww........w
w.......dwwwwwwk...d...w
w..........ww..........w
w...k......ww......k...w
w......d...............w
w.d........k......wk...w
w..............d..w....w
w...k...d.........wd...w
w......k......d...w...Aw
wwwwwwwwwwwwwwwwwwwwwwww