wwwwwwwwwwwwwwwwwwwwwwww
w...k.......d...e.e....w
w......k.e...........k.w
w..d........e....d.....w
w......e.k.............w
w....kk........k...d...w
w......................w
w..d......k.e....e.....w
w..............k.....d.w
w..d.....e.............w
w.......d......k...d...w
w...........e..........w
w...k..e...d.....e.k...w
w......d...............w
w.d........k...e...k...w
w......e...............w
w...k...d...e......d...w
w......k......d......BAw
wwwwwwwwwwwwwwwwwwwwwwww