wwwwwwwwwwwwwwwwwwwwwwww
wB..k......k...........w
w.................d..k.w
w......................w
wwwww....k..........k..w
w....k......d..k.......w
w..........ww..........w
w.....k...kww..........w
wk.........ww........d.w
w..d.....wwwwww.......kw
w.......dwwwwwwk.......w
wk......k..ww..........w
w..........ww......k...w
w......................w
w.d........k......wk...w
w..............d..w....w
w...k...d.........w....w
w............k....w...Aw
wwwwwwwwwwwwwwwwwwwwwwww